│Y────┬─────────┬─┬─────┬───┬───────┬───────────┬─────────────┬───┬─┬─┬─────┬───┬─┬─┬───┬───────┐
│     │         │ │     │   │       │           │             │   │ │ │     │   │ │ │   │     │ │
├── ──┴─┬── ────┘ │ ────┼─┐ ├── ──┬─┴─┬─┐ ──┬── │ │ ──┬──── ──┘ ┌─┘ │ └── ──┼── │ │ ├── ├── ──┘ │
│       │               │ │ │     │   │ │   │     │   │         │           │       │   │       │
│ ┌─┬───┴─┬── │ ┌── ┌── │ │ └─┐ ──┼── │ ├── ├─┐ │ │ ┌─┴─┬─┬─┐ ──┴─────┬─┬─┐ └── ┌───┘ ┌─┴───┬─┐ │
│ │ │     │   │ │   │   │     │   │   │ │   │ │ │ │ │   │ │ │         │ │ │     │     │     │ │ │
│ │ │ ──┐ ├───┤ └─┬─┤ │ ├── │ │ │ │ ──┘ ├── │M└─┘ ├─┴── │ │ │ │ │ ──┐ │ │ │ ┌── └──── ├───┐ │ │ │
│   │   │ │   │   │ │ │ │   │   │ │     │   │     │           │ │   │ │     │         │   │     │
│ ──┘ │ │ │ ──┴─┐ │ └─┘ │ ┌─┘ ┌─┘ │ ──┐ │ │ ├───┬─┴─┬── │ │ │ ├─┘ ┌─┘ │ │ │ └─┬── ┌───┘ ┌─┴─┐ │ │
│     │ │       │ │       │   │   │   │ │ │ │   │   │   │ │ │ │   │     │ │   │   │     │   │ │ │
├── ┌─┴─┴─┐ ──┐ └─┴─┐ │ ──┼─┬─┴── │ ──┼─┴─┼─┘ ──┤ ┌─┤ ┌─┼─┴─┘ └───┤ ──┐ └─┼───┘ │ │ ┌───┤ ┌─┘ │ │
│   │     │   │     │ │   │ │         │   │     │ │ │ │ │         │   │   │     │   │   │ │   │ │
│ │ └── ┌─┴───┴── ──┘ │ ──┤ │ ──┬─┐ ──┘ ──┴── │ │ │ └─┤ └── ──┐ ┌─┼───┤ ┌─┴──── │ │ │ │ │ ├─┐ │ │
│ │     │             │   │     │ │           │       │       │ │ │   │ │       │ │ │ │   │ │ │ │
├─┤ ────┤ ┌──── │ ──┐ │ ──┼── ┌─┘ └───┐ ┌─┐ │ ├──── │ ├─┐ ┌── ├─┘ │ │ │ └───┐ ┌─┴─┴─┘ │ ──┘ └─┤ │
│ │     │ │     │   │ │   │   │       │ │ │ │ │     │ │ │ │   │     │ │     │ │       │       │ │
│ └─┐ ┌─┤ ├──── │ │ │ └─┐ ├─┐ │ ┌───┬─┘ │ └─┼─┴──── │ │ │ ├── ├───┐ └─┘ │ ──┼─┘ ┌─┬── ├───┐ ┌─┘ │
│   │ │ │ │     │ │ │   │ │ │   │   │   │   │       │ │   │   │   │     │   │   │ │   │   │ │   │
├─┐ │ │ └─┤ ┌───┤ └─┼─┬─┼─┤ │ │ │ │ └─┬─┘ │ │M┌── ──┤ │ ──┴─┬─┴── │ │ ┌─┼───┴───┘ │ ──┘ ──┤ │ │ │
│ │ │     │ │   │   │ │ │ │   │   │   │   │   │     │       │     │ │ │ │         │       │ │ │ │ 
│ │ │ ┌── │ └─┐ │ ──┘ │ │ ├── ├───┴─┬─┼── ├─┐ ├───┬─┴─┐ │ ┌─┤ │ ──┼─┤ │ │ │ ┌─────┼───┬───┤ │ └─│
│   │ │   │   │       │   │   │     │ │   │ │ │   │   │ │ │ │ │   │ │   │ │ │     │   │   │ │   │
├─┐ └─┼── └───┼─┬── │ │ ──┘ ┌─┘ ┌─┬─┤ └───┤ └─┴─┐ └─┐ │ └─┘ └─┤ ┌─┘ │ ──┤ └─┴──── │ ──┤ │ │ │ │ │
│ │   │       │ │   │ │     │   │ │ │     │     │   │ │       │ │       │             │ │     │ │ 
│ │ │ ├── │ ┌─┘ ├───┘ │ ────┘ │ │ │ │ ┌─┐ │ │ │ │ ──┤ └─┐ ┌── │ │ │ ┌── ├─┬── │ ┌─┬───┘ ├──── ├─│
│   │ │   │ │   │     │       │ │   │ │ │ │ │ │     │   │ │     │ │ │   │ │   │ │ │     │     │ │
│ │ └─┴───┘ │ │ └─┐ ──┤ ┌─┐ ──┴─┼── ├─┘ │ │ └─┼──── │ │ └─┴─┬─┬─┴─┴─┘ ──┤ │ ┌─┼─┘ └─┐ ──┤ │ │ │ │
│ │           │   │   │ │ │     │   │   │ │   │       │     │ │         │   │ │     │   │ │ │ │ │
├─┘ ──────┬───┤ ──┴───┤ │ │ │ ┌─┘ ──┴── │ │ ──┴─────┐ ├─┬── │ │ ──┬── │ ├── │ └───┐ │ ──┤ ├─┤ │ │
│         │   │       │ │   │ │         │           │ │ │   │ │   │   │ │   │     │     │ │ │ │ │
│ │ ┌─┐ ──┘ ┌─┘ │ ┌─┬─┴─┼───┘ └── │ ┌───┼──── ──┬── ├─┤ └───┘ ├── ├─┐ │ │ ──┼── │ └──── │ │ ├─┴─│
│ │ │ │     │   │ │ │   │         │ │   │       │   │ │       │   │ │ │     │   │       │   │   │
├─┼─┤ ├─┬── ├───┘ │ └─┐ └── ──┐ ┌─┘ │ ──┘ ┌─────┘ ┌─┘ │ │ ────┤ ──┘ ├─┼── ┌─┴─┬─┼─┐ ──┐ └─┬─┘ ┌─┤
│ │ │ │ │   │         │       │ │         │       │   │ │     │     │ │   │   │ │ │   │   │   │ │
│ │ │ │ │ ┌─┴───┐ │ ──┤ ┌─────┴─┘ ──┬───┐ ├── ┌── │ │ ├─┘ ┌───┘ │ ┌─┘ ├── │ │ │ │ └── ├─┐ ├── │ │
│     │ │ │     │ │   │ │           │   │ │   │   │ │ │   │     │ │   │   │ │         │ │ │     │
│ │ │ │ │ │ ──┐ ├─┘ ──┼─┤ │ ┌── ┌── │ │ ├─┴───┘ ──┼─┘ ├── └── ┌─┘ │ │ │ │ │ │ │ ──┐ ──┤ │ └─────│
│ │ │     │   │ │     │ │ │ │   │   │ │ │         │   │       │   │ │   │   │ │   │   │         X
├─┴─┘ ────┼───┘ └──── │ │ │ │ ┌─┘ │ │ └─┴─────┐ │ └── │ ┌── │ ├── └─┤ ──┤ ──┴─┴─┐ ├── │ │ ──────│
│         │             │ │ │ │   │           │ │     │ │   │ │     │   │       │ │   │ │       │
└─────────┴─────────────┴─┴─┴─┴───┴───────────┴─┴─────┴─┴───┴─┴─────┴───┴───────┴─┴───┴─┴───────┘
